[controller]
DPad=DPad
Thumbstick=Stick
Trigger=Trigger
LeftStick=Left Stick
RightStick=Right Stick
DPadUp=DPad Up
DPadDown=DPad Down
DPadLeft=DPad Left
DPadRight=DPad Right
Start=Start
Back=Back
LeftShoulder=Left Shoulder
RightShoulder=Right Shoulder
BigButton=Big Button
RightTrigger=Right Trigger
LeftTrigger=Left Trigger
RightThumbstickUp=Right Stick Up
RightThumbstickDown=Right Stick Down
RightThumbstickRight=Right Stick Right
RightThumbstickLeft=Right Stick Left
LeftThumbstickLeft=Left Stick Left
LeftThumbstickUp=Left Stick Up
LeftThumbstickDown=Left Stick Down
LeftThumbstickRight=Left Stick Right

[keyboard]
DirectionKeys=Direction Keys

[mouse]
Mouse=Mouse
MouseButton=Mouse Button
LeftMouseButton=Left Mouse Button
MiddleMouseButton=Middle Mouse Button
RightMouseButton=Right Mouse Button
MouseButtonX1=X1 Mouse Button
MouseButtonX2=X2 Mouse Button
