[controller]
DPad=DPad
Thumbstick=Stick
Trigger=Trigger
LeftStick=Left Stick
RightStick=Right Stick
DPadUp=DPad Up
DPadDown=DPad Κάτω
DPadLeft=DPad Αριστερά
DPadRight=DPad Δεξιά
Start=Start
Back=Back
LeftShoulder=Left Shoulder
RightShoulder=Right Shoulder
BigButton=Big Button
RightTrigger=Δεξί Trigger
LeftTrigger=Αριστερό Trigger
RightThumbstickUp=Δεξί Stick Πάνω
RightThumbstickDown=Δεξί Stick Κάτω
RightThumbstickRight=Δεξί Stick Δεξιά
RightThumbstickLeft=Δεξί Stick Αριστερά
LeftThumbstickLeft=Αριστερό Stick Αριστερά
LeftThumbstickUp=Αριστερό Stick Πάνω
LeftThumbstickDown=Αριστερό Stick Κάτω
LeftThumbstickRight=Αριστερό Stick Δεξιά

[keyboard]
DirectionKeys=Direction Keys

[mouse]
Mouse=Mouse
MouseButton=Mouse Button
LeftMouseButton=Αριστερό Mouse Button
MiddleMouseButton=Μεσαίο Mouse Button
RightMouseButton=Δεξί Mouse Button
MouseButtonX1=X1 Mouse Button
MouseButtonX2=X2 Mouse Button
