[controller]
DPad=DPad
Thumbstick=Levetta
Trigger=Grilletto
LeftStick=Levetta Sinistra
RightStick=Levetta Destra
DPadUp=DPad Su
DPadDown=DPad Giù
DPadLeft=DPad Sinistra
DPadRight=DPad Destra
Start=Start
Back=Indietro
LeftShoulder=Dorsale Sinistro
RightShoulder=Dorsale Destro
BigButton=Bottone Grande
RightTrigger=Grilletto Destro
LeftTrigger=Grilletto Sinistro
RightThumbstickUp=Levetta Destra Sù
RightThumbstickDown=Levetta Destra Giù
RightThumbstickRight=Levetta Destra a Destra
RightThumbstickLeft=Levetta destra a Sinistra
LeftThumbstickLeft=Levetta Sinistra a Sinistra
LeftThumbstickUp=Levetta Sinistra Sù
LeftThumbstickDown=Levetta Sinistra Giù
LeftThumbstickRight=Levetta Sinistra a Destra

[keyboard]
DirectionKeys=Tasti Direzionali

[mouse]
Mouse=Mouse
MouseButton=Tasto del Mouse
LeftMouseButton=Tasto Sinistro del Mouse
MiddleMouseButton=Tasto Centrale del Mouse
RightMouseButton=Tasto Destro del Mouse
MouseButtonX1=Tasto del Mouse X1
MouseButtonX2=Tasto del Mouse X2
