[controller]
DPad=DPad
Thumbstick=スティック
Trigger=トリガー
LeftStick=左スティック
RightStick=右スティック
DPadUp=DPad上
DPadDown=DPad下
DPadLeft=DPad左
DPadRight=DPad右
Start=開始
Back=戻る
LeftShoulder=左ショルダー
RightShoulder=右ショルダー
BigButton=大ボタン
RightTrigger=右トリガー
LeftTrigger=左トリガー
RightThumbstickUp=右スティック上
RightThumbstickDown=右スティック下
RightThumbstickRight=右スティック右
RightThumbstickLeft=右スティック左
LeftThumbstickLeft=左スティック左
LeftThumbstickUp=左スティック上
LeftThumbstickDown=左スティック下
LeftThumbstickRight=左スティック右

[keyboard]
DirectionKeys=方向キー

[mouse]
Mouse=マウス
MouseButton=マウスボタン
LeftMouseButton=マウス左ボタン
MiddleMouseButton=マウス中央ボタン
RightMouseButton=マウス右ボタン
MouseButtonX1=X1マウスボタン
MouseButtonX2=X2マウスボタン
