[controller]
DPad=Przyciski Kierunkowe
Thumbstick=Stick
Trigger=Trigger
LeftStick=Lewy Stick
RightStick=Prawy Stick
DPadUp=Strzałka w Górę
DPadDown=Strzałka w Dół
DPadLeft=Strzałka w Lewo
DPadRight=Strzałka w Prawo
Start=Start
Back=Powrót
LeftShoulder=Lewy Przycisk Ramienny
RightShoulder=Prawy Przycisk Ramienny
BigButton=Duży Przycisk
RightTrigger=Prawy Trigger
LeftTrigger=Lewy Trigger
RightThumbstickUp=Prawy Stick w Górę
RightThumbstickDown=Prawy Stick w Dół
RightThumbstickRight=Prawy Stick w Prawo
RightThumbstickLeft=Prawy Stick w Lewo
LeftThumbstickLeft=Lewy Stick w Lewo
LeftThumbstickUp=Lewy Stick w Górę
LeftThumbstickDown=Lewy Stick w Dół
LeftThumbstickRight=Lewy Stick w Prawo

[keyboard]
DirectionKeys=Klawisze Kierunkowe

[mouse]
Mouse=Mysz
MouseButton=Przycisk Myszy
LeftMouseButton=Lewy Przycisk Myszy
MiddleMouseButton=Środkowy Przycisk Myszy
RightMouseButton=Prawy Przycisk Myszy
MouseButtonX1=Przycisk Myszy X1
MouseButtonX2=Przycisk Myszy X2
