[controller]
DPad=Крестовина
Thumbstick=Стик
Trigger=Триггер
LeftStick=Левый стик
RightStick=Правый стик
DPadUp=Кнопка вверх
DPadDown=Кнопка вниз
DPadLeft=Кнопка влево
DPadRight=Кнопка вправо
Start=Старт
Back=Назад
LeftShoulder=Левое плечо
RightShoulder=Правое плечо
BigButton=Большая кнопка
RightTrigger=Правый триггер
LeftTrigger=Левый триггер
RightThumbstickUp=Правый стик вверх
RightThumbstickDown=Правый стик вниз
RightThumbstickRight=Правый стик вправо
RightThumbstickLeft=Правый стик влево
LeftThumbstickLeft=Левый стик влево
LeftThumbstickUp=Левый стик вверх
LeftThumbstickDown=Левый стик вниз
LeftThumbstickRight=Левый стик вправо

[keyboard]
DirectionKeys=Стрелки

[mouse]
Mouse=Мышь
MouseButton=Кнопка мыши
LeftMouseButton=Левая кнопка мыши
MiddleMouseButton=Колесо мыши
RightMouseButton=Правая кнопка мыши
MouseButtonX1=Х1 кнопка мыши
MouseButtonX2=Х2 кнопка мыши
