[controller]
DPad=十字键
Thumbstick=摇杆
Trigger=扳机
LeftStick=左摇杆
RightStick=右摇杆
DPadUp=十字键上
DPadDown=十字键下
DPadLeft=十字键左
DPadRight=十字键右
Start=开始
Back=返回
LeftShoulder=左肩键
RightShoulder=右肩键
BigButton=Big Button
RightTrigger=RT键
LeftTrigger=LT键
RightThumbstickUp=右摇杆上
RightThumbstickDown=右摇杆下
RightThumbstickRight=右摇杆右
RightThumbstickLeft=右摇杆左
LeftThumbstickLeft=左摇杆左
LeftThumbstickUp=左摇杆上
LeftThumbstickDown=左摇杆下
LeftThumbstickRight=左摇杆右

[keyboard]
DirectionKeys=方向键

[mouse]
Mouse=鼠标
MouseButton=鼠标按键
LeftMouseButton=鼠标左键
MiddleMouseButton=鼠标中键
RightMouseButton=鼠标右键
MouseButtonX1=鼠标按键X1
MouseButtonX2=鼠标按键X2
