[controller]
DPad=DPad
Thumbstick=Stick
Trigger=Trigger
LeftStick=Sol Stick
RightStick=Sağ Stick
DPadUp=Yukarı DPad
DPadDown=Aşağı DPad 
DPadLeft=Sol DPad 
DPadRight=Sağ DPad 
Start=Başla
Back=Geri
LeftShoulder=Sol Shoulder
RightShoulder=Sağ Shoulder
BigButton=Büyük Buton
RightTrigger=Sağ Trigger
LeftTrigger=Sol Trigger
RightThumbstickUp=Sağ Stick Yukarı
RightThumbstickDown=Sağ Stick Aşağı
RightThumbstickRight=Sağ Stick Sağ
RightThumbstickLeft=Sağ Stick Sol
LeftThumbstickLeft=Sol Stick Sol
LeftThumbstickUp=Sol Stick Yukarı
LeftThumbstickDown=Sol Stick Aşağı
LeftThumbstickRight=Sol Stick Sağ

[keyboard]
DirectionKeys=Yön Tuşları

[mouse]
Mouse=Fare 
MouseButton=Fare Tuşu
LeftMouseButton=Sol Fare Tuşu
MiddleMouseButton=Orta Fare Tuşu
RightMouseButton=Sağ Fare Tuşu
MouseButtonX1=X1 Fare Tuşu
MouseButtonX2=X2 Fare Tuşu
