[controller]
DPad=Хрестовина
Thumbstick=Стік
Trigger=Тригер
LeftStick=Лівий стік
RightStick=Правий стік
DPadUp=Кнопка вгору
DPadDown=Кнопка вниз
DPadLeft=Кнопка вліво
DPadRight=Кнопка вправо
Start=Старт
Back=Назад
LeftShoulder=Ліве плече
RightShoulder=Праве плечу
BigButton=Велика кнопка
RightTrigger=Правий тригер
LeftTrigger=Лівий тригер
RightThumbstickUp=Правий стік вгору
RightThumbstickDown=Правий стік вниз
RightThumbstickRight=Правий стік вправо
RightThumbstickLeft=Правий стік вліво
LeftThumbstickLeft=Лівий стік вліво
LeftThumbstickUp=Лівий стік вгору
LeftThumbstickDown=Лівий стік вниз
LeftThumbstickRight=Лівий стік вправо

[keyboard]
DirectionKeys=Стрілки

[mouse]
Mouse=Миш
MouseButton=Кнопка миші
LeftMouseButton=Ліва кнопка миші
MiddleMouseButton=Колесо миші
RightMouseButton=Права кнопка миші
MouseButtonX1=Х1 кнопка миші
MouseButtonX2=Х2 кнопка миші
