key (code reference) = Brazilian Portuguese
manage invites = ver convites pendentes
save_detail = Dados salvados para ibb & obb
Loading Trophies = Carrengando troféus
testing = Testando
Ok = ok
trailpointer hint = Tente usar o stick direito para se comunicar.
trailpointer hint PC = 
loading all = Carregando tudo que você vai precisar...
shaman intermezzo = Oi ibb, oi obb, /nEstão se divertindo? Espero que sim./nDeixem-me mostrar rapidamente um pouco mais /ndo que lhes espera e voltarei depois disso.
Full Zen (name) = 
Party (name) = 
All Crystals (name) = 
Collection Complete (name) = 
Brain Damage (name) = 
First Crystal (name) = 
Small Zen (name) = 
King Ubb (name) = 
Quality Time (name) = 
Fallcrobatics (name) = 
Mint Condition (name) = 
shaman text = Olá de novo meus amigos! /nVocês jogaram por uma pequena parte do jogo /ne viram algumas amostras do que ainda lhes aguarda à frente./nSe você gostou e quer mais, pode comprar o jogo completo na PlayStation®Store./nEspero ver vocês dois de novo!
play = Jogar
two player = Dois jogadores
online game = Jogo online
invite friend = Convide um amigo
single player = Um jogador
leaderboards = Classificação
friends = Amigos
local / friends = Amigos
worldwide = Mundial
buy = Compre o jogo completo
credits = Créditos
director = Diretor
co-director = Co-diretor
code lead = Programador líder
code = Programador
additional design = Design adicional
music = Música
sound design = Design de som
animations = Animações
strategy = Estratégia
production = Produção
guest artist = Artista convidado
Sony Europe = Sony Computer Entertainment Europe
Sony US = Sony Computer Entertainment America
financial support = Apoio financeiro
special thanks = Agradecimentos especiais
translations = Traduções
ibb and obb names = Nomes do ibb e obb
development babies = Nascido no desenvolvimento
back to game = Voltar ao jogo
restart in limbo = Reiniciar no Limbo
Pause_RestartWarning = Você quer reiniciar no Limbo?/nO progresso atual será perdido.
exit to main menu = Sair para o menu principal
Pause_QuitWarning = Você quer voltar ao menu principal?/nO progresso atual será perdido.
sound effect volume = Volume de efeitos sonoros
music volume = Volume da música
controller rumble = Vibração do controle
use analogue stick to change volume = Use o stick analógico para alterar o volume
title = ibb e obb
ibb = ibb
obb = obb
On = Liga
Off = Desliga
Yes = Sim
No = Não
Cancel = Cancelar
X confirm = \X confirma
O back to menu = \O voltar ao menu
X select = \X selecionar
O back = \O voltar
X select O back = \X selecionar \O voltar
P sign in = \P entrar
back = voltar
press start = aperte start
Chat restricted = Chat está desbilitado na sua conta Sony Entertainment Network devido a restrições no chat
Sign-in Prompt = Você precisa entrar na sua conta Sony Entertainment Network pra usar esse recurso./nVocê quer entrar?
Sign-in Reminder = Você não pode usar esse recurso se não entrar na sua conta Sony Entertainment Network.
Not Own Save Data = Os dados desse perfil pertencem à outro usuário./nTroféus não são desbloqueáveis e você não pode salvar dados nesse perfil durante esta sessão.
Not Own Save Data 2 = Os dados desse perfil pertencem à outro usuário./nVocê não pode salvar seu jogo durante esta sessão./nQuer usar este perfil mesmo assim?
MenuItemDemoText = (não disponível no demo)
Not Allowed Online Services = Serviço online desativado na sua conta Sony Entertainment Network devido a restrições
playground message = Esperando por outro jogador participar...
Indicator Warning = Não desligue seu PlayStation®3 quando o ícone de salvar estiver visível
InternalError_OtherPlayerLeftTheGame = Conexão com o outro jogador foi perdida.
InternalError_UserCancelledInvite = sem texto
InternalError_NotSignedInPSN = Você não está mais conectado a sua conta PlayStation®Network
InternalError_PSNInitializationFailed = Não é possível iniciar a conexão com a PlayStation®Network./nTente reiniciar o jogo.
PSNError_Generic = Erro ao conectar à PlaysationNetwork
PSNError_ServerUnavailable = A PlayStation®Network está indisponível no momento./nPor favor tente mais tarde novamente.
PSNError_NotConnected = Erro: não está conectado à PlayStation®Network
PSNError_InternalServerError = Erro no servidor interno PlayStation®Network.
PSNError_ServerBusy = O servidor da PlayStation®Network está temporariamente cheio./nPor favor tente novamente mais tarde.
PSNError_PlayerBanned = Você foi banido do servidor PlayStation®Network.
PhotonError_Generic = Erro ao conectar aos servidores multiplayer de ibb & obb
PhotonError_GameFull = Não é possível se juntar ao jogo: já está cheio
PhotonError_GameClosed = O convite foi cancelado ou o jogo foi encerrado
PhotonError_ServerFull = Os servidores multiplayer de ibb & obb estão cheios no momento./nPor favor tente novamente mais tarde.
PhotonError_GameIdAlreadyExists = Esse jogo já existe nos servidores multiplayer de ibb & obb
PSNError_SendFailure = Falha ao enviar a mensagem:/nO destinatário está em uma lista de bloqueio ou houve falha no envio da rede.
PSNError_TimeOut = Erro: a operação encerrou
PSNError_ServiceUnavailable = O serviço está temporariamente desativado./nPor favor tente novamente mais tarde
Full Zen = Termine todos os níveis com a maior pontuação possível.
Party = Jogue por todos os níveis regulares.
All Crystals = Colete todos os cristais de todos os níveis secretos.
Collection Complete = Encontre todos os levelmen e secretmen.
Brain Damage = Termine o jogo no modo de jogador único.
First Crystal = Colete um cristal de um nível secreto.
Small Zen = Termine um nível com a maior pontuação possível
King Ubb = Encontre ubb e traga-o até a próxima Fin City.
Quality Time = Jogue um Fin entre ibb e obb 10 vezes
Fallcrobatics = Atravesse 6 passagens diferentes sem encostar no chão.
Mint Condition = Termine um nível sem morrer.
invite_message = Oi. Quer se juntar à mim para um jogo de ibb e obb?
go to store = Vá à PlaystationStore
no online game in demo = Jogo online: não disponível no demo.
Valve = Valve
local game = Partida local
settings = Configurações
quit = Sair
start game = Iniciar jogo
fullscreen = Tela cheia
antialiasing = Bordas suaves
apply = Aplicar
reset progress = Reiniciar progresso
marketing = Assistente de marketing
voice chat = Chat de voz
CRC check failed = We have detected that the file <FILE> was changed./nAchievements, leaderboards, multiplayer and saving are disabled
SteamError_Generic = Erro ao conectar aos servidores multiplayer de ibb & obb
press space to return to main menu = 
network status = 
Voice Chat unavailable = 
start = 
connect online = 
multiplayer = 
connect = 
disconnect = 
host = 
join = 
start from constants = 
new game = 
continue = 
local = 
network status: Uninitialized = 
